,Muni,Evictions per Rented Households,Eviction Numbers,Estimate!!Total:,Estimate!!Total:!!Not Hispanic or Latino:,Estimate!!Total:!!Not Hispanic or Latino:!!White alone,Estimate!!Total:!!Not Hispanic or Latino:!!Black or African American alone,Estimate!!Total:!!Not Hispanic or Latino:!!American Indian and Alaska Native alone,Estimate!!Total:!!Not Hispanic or Latino:!!Asian alone,Estimate!!Total:!!Not Hispanic or Latino:!!Native Hawaiian and Other Pacific Islander alone,Estimate!!Total:!!Not Hispanic or Latino:!!Some other race alone,Estimate!!Total:!!Not Hispanic or Latino:!!Two or more races:,Estimate!!Total:!!Not Hispanic or Latino:!!Two or more races:!!Two races including Some other race,"Estimate!!Total:!!Not Hispanic or Latino:!!Two or more races:!!Two races excluding Some other race, and three or more races",Estimate!!Total:!!Hispanic or Latino:,Estimate!!Total:!!Hispanic or Latino:!!White alone,Estimate!!Total:!!Hispanic or Latino:!!Black or African American alone,Estimate!!Total:!!Hispanic or Latino:!!American Indian and Alaska Native alone,Estimate!!Total:!!Hispanic or Latino:!!Asian alone,Estimate!!Total:!!Hispanic or Latino:!!Native Hawaiian and Other Pacific Islander alone,Estimate!!Total:!!Hispanic or Latino:!!Some other race alone,Estimate!!Total:!!Hispanic or Latino:!!Two or more races:,Estimate!!Total:!!Hispanic or Latino:!!Two or more races:!!Two races including Some other race,"Estimate!!Total:!!Hispanic or Latino:!!Two or more races:!!Two races excluding Some other race, and three or more races"
0,Worcester,0.089063913,3743,185143,144633,102148,22594,712,13675,111,1096,4297,426,3871,40510,25894,2010,412,20,0,9131,3043,1240,1803
1,Springfield,0.099119455,2983,154139,84838,48145,28543,312,3927,11,417,3483,204,3279,69301,49469,3735,366,230,0,12033,3468,1210,2258
2,Fall River,0.096138145,2355,89388,79968,69030,4729,124,1680,0,741,3664,249,3415,9420,3025,509,0,45,43,5485,313,111,202
3,New Bedford,0.098129435,2282,95239,75413,57575,6051,27,1476,25,6820,3439,1528,1911,19826,2908,585,51,0,0,14755,1527,969,558
4,Lowell,0.076544295,1741,111306,91174,54254,8002,699,25568,113,580,1958,216,1742,20132,13595,932,155,79,52,4462,857,312,545
5,Brockton,0.105259482,1507,95594,84993,29407,42122,394,1882,0,8767,2421,1140,1281,10601,5120,1460,52,40,0,2985,944,657,287
6,Boston,0.007945704,1392,684379,548622,304524,155096,1376,65613,365,5278,16370,1849,14521,135757,56931,17555,641,594,53,40240,19743,2933,16810
7,Lynn,0.067086071,1205,93743,53648,33635,10164,168,6750,92,680,2159,218,1941,40095,11893,2638,189,75,0,21273,4027,1287,2740
8,Lawrence,0.066662945,1194,79942,15479,11856,1775,0,1321,0,350,177,14,163,64463,30376,2755,249,42,0,28728,2313,914,1399
9,Framingham,0.088700999,1154,72308,60660,45534,4504,258,5635,65,3049,1615,297,1318,11648,4720,784,100,63,0,5724,257,86,171
10,Quincy,0.039263471,870,94207,91299,55540,4689,108,28532,146,634,1650,97,1553,2908,2041,146,14,70,0,508,129,48,81
11,Pittsfield,0.1154628,852,42766,39875,35619,1737,55,860,36,94,1474,11,1463,2891,1514,168,26,0,0,879,304,105,199
12,Fitchburg,0.11167002,777,40702,28990,25366,1482,121,942,0,45,1034,63,971,11712,7337,536,48,14,0,2840,937,511,426
13,Haverhill,0.072753484,757,63533,48811,44300,1941,42,845,0,111,1572,87,1485,14722,6714,369,22,1,23,6716,877,181,696
14,Revere,0.071754933,691,53692,35650,28634,2673,32,2596,0,886,829,0,829,18042,13299,269,108,13,0,2323,2030,518,1512
15,Holyoke,0.07517386,681,40241,18537,16636,1162,78,239,0,3,419,0,419,21704,18582,664,55,35,35,1721,612,141,471
16,Chicopee,0.066115702,632,55421,43801,39456,2296,56,1306,0,29,658,10,648,11620,8100,560,0,0,0,2432,528,398,130
17,Cambridge,0.020533141,627,116632,105566,69795,11576,145,19352,116,423,4159,302,3857,11066,7316,936,47,69,11,1732,955,362,593
18,Taunton,0.072686177,611,57124,51958,42826,4789,12,1050,0,1673,1608,157,1451,5166,2797,237,3,9,0,1416,704,462,242
19,Randolph,0.15376514,584,34064,31054,10005,14890,27,4472,12,857,791,137,654,3010,929,339,0,38,0,1388,316,41,275
20,Marlborough,0.082129278,540,39736,33751,27491,1522,0,2169,0,1490,1079,364,715,5985,2396,3,39,0,49,2936,562,314,248
21,Malden,0.038942874,529,60984,55817,28672,10849,20,13696,14,774,1792,208,1584,5167,3739,404,0,36,0,850,138,59,79
22,Chelsea,0.049537178,487,39992,13198,8251,2147,0,1489,0,177,1134,48,1086,26794,11093,414,21,115,0,3171,11980,308,11672
23,Salem,0.04798121,429,43252,35542,31076,2040,144,1085,0,126,1071,96,975,7710,3100,815,127,0,0,3103,565,214,351
24,Somerville,0.018962351,413,80906,70911,55183,4534,112,8246,5,714,2117,92,2025,9995,6113,451,47,57,0,2003,1324,193,1131
25,Leominster,0.055899747,397,41606,33930,28820,2417,61,1192,0,292,1148,40,1108,7676,4862,388,18,71,0,1986,351,74,277
26,Everett,0.040361936,397,46118,33089,20125,7625,10,3754,5,655,915,121,794,13029,6537,690,490,0,42,4019,1251,168,1083
27,Peabody,0.053333333,396,52906,47672,43772,1745,179,590,0,238,1148,398,750,5234,3791,256,13,0,0,870,304,151,153
28,Braintree,0.096723044,366,37220,36443,29552,993,42,5149,0,152,555,0,555,777,461,110,21,0,0,133,52,33,19
29,Waltham,0.028753714,329,62777,54241,41364,4205,141,7309,0,58,1164,70,1094,8536,3782,245,126,12,0,3133,1238,276,962
30,Norwood,0.064478081,328,29306,27322,23574,1670,0,1581,0,91,406,6,400,1984,1153,426,0,0,0,318,87,34,53
31,Gardner,0.080526716,318,20610,18698,16742,477,11,651,0,60,757,8,749,1912,1180,109,0,0,0,505,118,53,65
32,Attleboro,0.057090576,312,44789,41837,37274,1790,24,1868,28,140,713,119,594,2952,2180,202,0,0,8,524,38,17,21
33,North Adams,0.12357655,293,12959,12109,11146,210,15,133,23,5,577,0,577,850,353,11,32,0,0,350,104,73,31
34,Southbridge,0.076821889,292,16887,11339,10626,323,7,63,0,19,301,6,295,5548,3247,252,42,9,0,1600,398,147,251
35,Methuen,0.057437116,290,50282,35445,30602,1591,9,2048,0,174,1021,35,986,14837,6885,567,126,27,0,6299,933,233,700
36,Medford,0.026501943,266,57637,53908,40981,5263,27,5643,21,294,1679,173,1506,3729,2313,61,47,64,0,447,797,90,707
37,Plymouth,0.05591897,265,60024,58587,54960,1035,39,895,0,515,1143,158,985,1437,850,108,25,0,0,293,161,37,124
38,Stoughton,0.082655386,254,28639,27548,20472,4230,116,1439,0,384,907,147,760,1091,515,64,0,0,0,421,91,0,91
39,Milford,0.070385514,241,28883,24835,21321,656,20,797,0,1470,571,205,366,4048,2150,19,5,0,0,1733,141,83,58
40,Beverly,0.036649215,238,41885,39740,37088,686,40,881,5,41,999,104,895,2145,1471,201,0,22,23,313,115,16,99
41,Webster,0.072312084,228,16973,14924,13575,787,26,218,0,88,230,0,230,2049,690,48,0,0,0,1108,203,134,69
42,Bridgewater,0.097877869,226,27436,26361,22905,2185,51,580,15,195,430,42,388,1075,391,175,18,12,0,344,135,0,135
43,West Springfield,0.042557289,221,28609,25579,22782,803,70,1158,0,15,751,44,707,3030,2124,113,21,0,0,618,154,108,46
44,Weymouth,0.026826776,210,56734,54581,46272,3108,35,3828,0,562,776,13,763,2153,1534,81,29,52,0,319,138,69,69
45,Rockland,0.120184014,209,17953,17392,16421,475,0,101,0,235,160,21,139,561,455,58,0,0,0,33,15,0,15
46,Woburn,0.033571197,207,40304,38465,31195,2193,0,3555,0,627,895,140,755,1839,924,204,0,0,0,567,144,21,123
47,Greenfield,0.056485949,199,17375,16044,15094,333,7,220,0,14,376,0,376,1331,639,58,6,7,0,569,52,32,20
48,Westfield,0.037619427,189,41449,37491,35235,598,46,1167,0,9,436,17,419,3958,3042,85,0,0,71,692,68,24,44
49,Athol,0.132511556,172,11713,11076,10558,75,11,42,0,52,338,48,290,637,259,54,0,0,0,294,30,30,0
50,Mansfield,0.068544996,163,23947,22977,20686,466,0,1442,0,80,303,0,303,970,788,93,52,0,0,24,13,0,13
51,Tewksbury,0.086355786,150,31098,30408,28021,638,6,1102,0,123,518,10,508,690,512,99,0,0,0,78,1,1,0
52,North Andover,0.047199497,150,30842,28510,25018,944,8,1883,0,18,639,0,639,2332,1459,163,14,0,0,623,73,26,47
53,Westborough,0.056978967,149,19037,17853,12371,342,91,4747,0,77,225,34,191,1184,927,28,21,15,0,153,40,0,40
54,Saugus,0.073689416,149,28215,25776,23505,575,96,1065,0,61,474,28,446,2439,2086,19,0,0,0,321,13,13,0
55,Danvers,0.046951418,144,27586,26192,24165,638,16,715,0,23,635,26,609,1394,1120,35,0,0,0,227,12,0,12
56,Gloucester,0.029243484,138,30162,29425,27724,428,13,587,0,27,646,0,646,737,512,74,0,0,0,110,41,11,30
57,Canton,0.064516129,138,23369,22415,18912,1223,83,1661,0,236,300,12,288,954,484,2,14,18,14,337,85,17,68
58,Franklin,0.056423611,130,33256,32725,29664,301,0,1915,5,43,797,28,769,531,466,4,0,0,0,31,30,0,30
59,Brookline,0.010411661,130,59180,55168,40268,1746,28,10258,13,218,2637,181,2456,4012,2330,177,76,0,0,1052,377,105,272
60,Dracut,0.050792361,125,31373,29304,26173,1228,0,1241,26,180,456,143,313,2069,1551,197,0,0,0,149,172,47,125
61,Shrewsbury,0.03451155,124,37416,35633,26161,1109,45,7131,0,273,914,89,825,1783,1112,15,20,15,0,220,401,89,312
62,Whitman,0.070099256,113,15056,14677,13813,244,0,116,0,167,337,31,306,379,113,44,0,0,0,153,69,62,7
63,Adams,0.074797844,111,8125,8007,7753,73,2,65,0,6,108,2,106,118,65,0,0,0,0,36,17,5,12
64,Winthrop,0.03214596,111,18542,16775,16044,299,0,177,0,39,216,0,216,1767,1185,104,10,0,0,291,177,18,159
65,Abington,0.063854716,109,16436,16006,14493,331,0,599,0,146,437,35,402,430,363,0,0,0,0,45,22,0,22
66,Chelmsford,0.049318929,105,35126,33957,29915,309,0,3201,8,35,489,95,394,1169,709,1,15,26,0,258,160,104,56
67,Wareham,0.039969254,104,22641,21828,19131,493,0,147,0,1122,935,236,699,813,271,113,144,0,0,64,221,93,128
68,Ware,0.071777003,103,9801,9050,8752,131,0,22,0,0,145,0,145,751,628,0,0,0,0,30,93,19,74
69,Spencer,0.071080139,102,11928,11533,10734,115,0,415,0,0,269,0,269,395,395,0,0,0,0,0,0,0,0
70,Billerica,0.034670292,102,43200,41241,35320,2034,0,3075,47,141,624,182,442,1959,767,25,0,21,29,892,225,49,176
71,Andover,0.042206435,101,35816,34048,27139,945,11,5250,0,5,698,57,641,1768,1467,13,14,25,0,201,48,25,23
72,Marshfield,0.05574136,100,25838,25287,24872,56,0,140,7,29,183,45,138,551,346,95,0,0,0,11,99,86,13
73,Clinton,0.037519142,98,13935,11528,10841,154,3,251,0,135,144,0,144,2407,1586,294,114,0,0,380,33,0,33
74,Mashpee,0.112676056,96,14148,14060,12128,456,699,316,0,140,321,50,271,88,67,0,21,0,0,0,0,0,0
75,Oxford,0.06795422,95,13974,13195,12287,215,0,351,0,34,308,0,308,779,255,63,0,0,0,291,170,159,11
76,Orange,0.095137421,90,7644,7456,7239,43,29,66,0,0,79,0,79,188,140,0,0,0,0,0,48,0,48
77,Amherst,0.017677287,86,39814,36838,27619,1976,87,5384,119,32,1621,107,1514,2976,1902,141,88,37,0,502,306,143,163
78,Amesbury,0.039534884,85,17434,16998,16354,99,20,189,0,0,336,0,336,436,405,0,28,0,0,3,0,0,0
79,Dedham,0.030367989,85,25283,23074,19935,1727,21,689,8,175,519,229,290,2209,1379,357,7,0,7,350,109,77,32
80,Ashland,0.071912014,85,17710,16464,13801,367,38,1996,0,0,262,0,262,1246,825,30,0,0,0,309,82,23,59
81,Holbrook,0.108247423,84,11045,10321,7963,1733,0,385,0,23,217,12,205,724,365,122,0,0,0,70,167,167,0
82,Hull,0.060830861,82,10455,10273,9893,51,0,104,0,12,213,0,213,182,150,0,10,0,0,22,0,0,0
83,Arlington,0.010116148,81,45304,43078,34356,1387,27,5567,0,92,1649,23,1626,2226,1734,16,18,0,0,392,66,35,31
84,Northampton,0.015923567,80,28516,26026,23447,602,36,932,0,12,997,19,978,2490,1789,13,7,16,10,464,191,144,47
85,Watertown,0.010626993,80,35401,32129,27055,536,15,3497,0,286,740,153,587,3272,2248,41,81,0,0,760,142,0,142
86,Winchendon,0.075046904,80,10841,10494,9840,122,0,283,0,0,249,34,215,347,241,7,0,0,0,81,18,0,18
87,Wakefield,0.028529627,78,26993,26061,24563,457,6,647,0,30,358,10,348,932,635,16,9,0,0,272,0,0,0
88,Bellingham,0.064026959,76,17108,16428,15643,290,0,248,0,12,235,38,197,680,471,29,0,0,0,180,0,0,0
89,Belchertown,0.073500967,76,15005,14791,13793,83,0,654,0,39,222,0,222,214,214,0,0,0,0,0,0,0,0
90,Natick,0.01658925,75,36128,34663,28501,652,37,4642,3,125,703,192,511,1465,1056,25,0,19,0,336,29,0,29
91,Norton,0.075102881,73,19745,19204,17839,749,15,295,0,42,264,0,264,541,375,60,0,0,0,98,8,8,0
92,Ludlow,0.032603633,70,21291,19454,18577,225,24,222,0,0,406,0,406,1837,1092,77,0,21,0,510,137,137,0
93,Lunenburg,0.100286533,70,11402,10728,10079,148,0,162,0,46,293,15,278,674,624,41,0,0,0,9,0,0,0
94,Fairhaven,0.044900577,70,16045,15718,14531,110,0,576,0,369,132,0,132,327,84,0,0,0,21,192,30,30,0
95,Hudson,0.032317636,70,19887,18728,17746,237,0,538,0,51,156,17,139,1159,961,0,0,0,0,198,0,0,0
96,Seekonk,0.069387755,68,15441,15048,14245,107,0,194,76,31,395,259,136,393,288,42,0,0,0,29,34,0,34
97,Stoneham,0.020035885,67,23223,22449,20357,653,0,1040,0,135,264,26,238,774,628,43,0,0,0,103,0,0,0
98,Needham,0.038550058,67,30970,29971,25595,881,22,2738,0,0,735,76,659,999,815,10,0,19,0,140,15,8,7
99,Walpole,0.0423247,67,25129,23144,20800,512,69,1255,0,127,381,0,381,1985,1328,28,24,0,0,590,15,15,0
100,Northborough,0.061776062,64,15056,14651,12457,489,42,1378,0,17,268,21,247,405,208,0,0,0,9,162,26,26,0
101,Salisbury,0.08951049,64,9360,9025,8688,67,0,104,22,81,63,0,63,335,289,0,12,0,0,6,28,17,11
102,Burlington,0.023484848,62,27650,26805,19772,1250,48,4636,54,59,986,139,847,845,773,0,0,0,0,21,51,17,34
103,Millbury,0.044034091,62,13732,13563,12515,195,6,332,54,148,313,17,296,169,106,0,0,14,0,20,29,0,29
104,Raynham,0.0625,62,14196,13910,13242,247,0,128,0,40,253,39,214,286,178,1,0,0,0,36,71,71,0
105,Melrose,0.01600413,62,28113,27227,24093,811,0,1736,0,0,587,11,576,886,693,0,0,0,0,98,95,27,68
106,Ayer,0.045906656,60,8106,7640,6679,349,23,287,0,0,302,0,302,466,458,0,0,0,0,8,0,0,0
107,Falmouth,0.019318926,59,31124,30341,27652,615,183,572,0,445,874,95,779,783,683,5,29,0,0,7,59,0,59
108,Palmer,0.041968162,58,12237,11681,10691,261,0,240,0,0,489,0,489,556,302,12,0,0,0,104,138,114,24
109,Westwood,0.069174757,57,16136,15650,13686,113,0,1426,0,124,301,0,301,486,236,0,0,12,0,135,103,85,18
110,Easthampton,0.01987225,56,15960,15237,14238,300,0,247,0,0,452,0,452,723,496,0,0,0,0,127,100,100,0
111,South Hadley,0.030454042,55,17703,16568,15007,310,8,765,0,34,444,0,444,1135,773,5,0,0,0,110,247,76,171
112,Agawam,0.019217331,55,28696,27152,25519,609,6,450,0,0,568,0,568,1544,1295,15,0,109,0,74,51,32,19
113,Hingham,0.02892562,49,23652,23383,22526,130,0,390,0,24,313,3,310,269,194,0,17,42,0,2,14,1,13
114,Bedford,0.034632035,48,14142,13598,10492,565,25,2116,0,0,400,0,400,544,447,14,0,0,0,34,49,0,49
115,Newburyport,0.026315789,47,18077,17568,16712,296,0,405,0,0,155,0,155,509,303,14,0,0,0,42,150,0,150
116,Auburn,0.046673287,47,16684,15924,15271,138,9,322,0,6,178,0,178,760,567,19,0,0,0,104,70,10,60
117,Lakeville,0.076298701,47,11372,11056,10506,231,0,88,0,10,221,11,210,316,239,2,9,0,0,46,20,20,0
118,Belmont,0.013199426,46,26113,24982,19102,373,47,4479,0,65,916,0,916,1131,968,11,27,0,0,50,75,14,61
119,Hanover,0.078767123,46,14459,14368,13957,143,0,55,0,97,116,0,116,91,60,0,0,0,0,31,0,0,0
120,Hopkinton,0.042950514,46,17598,17037,14358,321,22,2004,0,20,312,0,312,561,430,12,0,0,0,114,5,3,2
121,Carver,0.113924051,45,11720,11443,10837,64,0,145,0,171,226,0,226,277,243,0,23,0,0,11,0,0,0
122,Pembroke,0.045135406,45,18380,18101,17179,118,0,230,0,139,435,34,401,279,240,0,0,0,0,39,0,0,0
123,Swampscott,0.034013605,45,15002,14627,13757,226,0,331,0,0,313,21,292,375,274,0,0,0,0,95,6,0,6
124,Westport,0.039215686,44,15925,15652,15452,10,0,37,0,0,153,0,153,273,185,1,0,0,0,49,38,37,1
125,Wilmington,0.038972542,44,23377,23145,20338,949,0,1448,0,24,386,102,284,232,76,0,0,0,10,146,0,0,0
126,Dudley,0.035003978,44,11723,11300,10362,221,54,390,0,13,260,4,256,423,280,8,0,0,0,115,20,9,11
127,Sudbury,0.080223881,43,19122,18640,15779,326,7,1937,0,0,591,0,591,482,426,21,0,0,0,23,12,12,0
128,Marblehead,0.02384914,43,20500,19483,18677,285,0,287,0,52,182,0,182,1017,920,50,0,0,0,37,10,10,0
129,Pepperell,0.046822742,42,12105,11867,11261,96,0,274,0,33,203,0,203,238,202,0,0,0,0,22,14,14,0
130,Medfield,0.073741007,41,12841,12583,11693,110,0,619,0,0,161,0,161,258,258,0,0,0,0,0,0,0,0
131,Nantucket,0.037442922,41,11168,10703,9513,736,32,71,7,0,344,88,256,465,235,135,0,0,0,95,0,0,0
132,Uxbridge,0.040650407,40,13993,13754,13280,259,0,65,0,20,130,0,130,239,165,0,0,0,0,74,0,0,0
133,Westford,0.033840948,40,24342,23973,18523,196,22,4828,0,0,404,0,404,369,345,13,0,0,0,11,0,0,0
134,Ipswich,0.02392638,39,13963,13382,12839,286,0,127,0,0,130,7,123,581,342,15,0,1,0,197,26,13,13
135,Kingston,0.042222222,38,13566,13078,12709,8,0,48,0,30,283,0,283,488,423,2,0,0,0,63,0,0,0
136,Lexington,0.017584452,38,33340,32632,20888,390,9,10028,0,223,1094,39,1055,708,380,40,49,0,0,93,146,0,146
137,Plainville,0.03507109,37,9183,8769,8075,111,0,375,0,132,76,0,76,414,80,334,0,0,0,0,0,0,0
138,Acton,0.016306743,37,23627,22790,15628,324,26,6132,22,13,645,18,627,837,644,35,0,17,0,94,47,0,47
139,Duxbury,0.057364341,37,15812,15677,15097,121,12,303,0,0,144,8,136,135,124,0,0,0,0,10,1,1,0
140,Milton,0.025843503,36,27572,26690,19779,4116,98,1795,27,87,788,28,760,882,374,45,0,35,0,254,174,55,119
141,Somerset,0.025880661,36,18165,18000,17711,89,0,56,0,59,85,70,15,165,151,0,0,0,0,0,14,14,0
142,Reading,0.023271732,34,25132,24371,22891,107,6,1112,0,76,179,0,179,761,409,0,0,0,0,211,141,88,53
143,Newton,0.003961319,34,88593,84243,65272,2509,87,13151,8,435,2781,250,2531,4350,2636,114,20,0,0,1238,342,88,254
144,Northbridge,0.015151515,34,16582,15551,14490,316,54,183,18,14,476,12,464,1031,594,14,0,6,0,262,155,43,112
145,Charlton,0.032136106,34,13550,12719,12263,120,0,87,0,11,238,0,238,831,588,0,18,0,0,54,171,171,0
146,Holden,0.042199488,33,19051,18234,17430,132,0,390,7,20,255,13,242,817,665,37,12,0,0,35,68,9,59
147,Scituate,0.035675676,33,18720,18534,17834,124,0,50,0,322,204,34,170,186,129,0,0,0,0,18,39,39,0
148,Swansea,0.044,33,16567,16490,15963,19,36,181,0,37,254,95,159,77,53,6,0,0,0,18,0,0,0
149,Sharon,0.044897959,33,18526,17521,13545,490,18,3103,0,94,271,16,255,1005,696,0,0,0,0,265,44,5,39
150,Shirley,0.04826546,32,7633,6884,5716,644,0,308,0,0,216,0,216,749,209,2,0,0,0,515,23,17,6
151,Maynard,0.034330011,31,10754,10388,9880,144,0,186,0,58,120,0,120,366,61,0,0,0,0,242,63,63,0
152,Bourne,0.012626263,30,19831,19054,18020,180,38,195,0,193,428,20,408,777,353,10,13,58,0,73,270,270,0
153,North Reading,0.044052863,30,15581,15262,13913,184,0,721,0,99,345,30,315,319,237,18,0,20,0,44,0,0,0
154,Harwich,0.034897714,29,12147,11875,11145,377,0,52,12,175,114,0,114,272,202,6,0,0,0,0,64,20,44
155,Millis,0.050089445,28,8233,8045,7650,187,0,127,0,62,19,0,19,188,44,0,0,0,0,144,0,0,0
156,Cohasset,0.040345821,28,8484,8365,8095,51,12,85,21,33,68,0,68,119,95,6,0,0,0,0,18,0,18
157,Wrentham,0.043613707,28,11823,11481,10962,339,16,114,0,6,44,4,40,342,323,0,0,0,0,19,0,0,0
158,Brewster,0.041538462,27,9837,9621,9316,89,0,57,0,0,159,0,159,216,177,5,0,0,34,0,0,0,0
159,Great Barrington,0.030100334,27,6901,6464,5921,257,6,191,0,14,75,0,75,437,257,2,0,0,0,178,0,0,0
160,Townsend,0.055670103,27,9473,9170,8938,46,0,125,0,47,14,0,14,303,250,37,0,0,0,1,15,0,15
161,East Bridgewater,0.029284165,27,14466,14158,12736,559,0,220,0,221,422,10,412,308,308,0,0,0,0,0,0,0,0
162,Blackstone,0.03307888,26,9263,9044,8657,112,43,71,0,0,161,53,108,219,164,3,0,0,0,42,10,10,0
163,Sandwich,0.036568214,26,20286,19850,18862,201,38,322,0,246,181,0,181,436,419,0,0,0,0,0,17,0,17
164,Leicester,0.026824034,25,11306,10876,10287,340,11,52,19,0,167,2,165,430,324,21,0,0,0,59,26,6,20
165,West Boylston,0.056930693,23,7966,6989,6327,432,7,115,0,14,94,8,86,977,735,69,7,32,0,75,59,24,35
166,Lynnfield,0.033674963,23,12894,12580,11693,76,0,564,0,0,247,0,247,314,212,82,0,0,0,20,0,0,0
167,Hanson,0.066282421,23,10777,10676,10056,27,0,329,0,79,185,28,157,101,98,3,0,0,0,0,0,0,0
168,Eastham,0.103603604,23,4901,4858,4485,83,23,151,0,48,68,0,68,43,43,0,0,0,0,0,0,0,0
169,Warren,0.053398058,22,5213,5151,4986,33,0,132,0,0,0,0,0,62,62,0,0,0,0,0,0,0,0
170,Medway,0.046025105,22,13325,12985,11999,362,4,317,0,22,281,40,241,340,109,13,0,0,0,12,206,186,20
171,East Longmeadow,0.02027027,21,16242,15613,13848,756,19,714,0,9,267,0,267,629,560,14,0,0,0,42,13,13,0
172,Dartmouth,0.008488278,21,34204,33157,30489,1006,6,848,0,106,702,83,619,1047,520,76,0,0,0,423,28,21,7
173,North Brookfield,0.042424242,21,4774,4699,4602,48,0,28,0,0,21,0,21,75,47,1,0,0,0,14,13,0,13
174,Provincetown,0.057692308,21,2973,2849,2662,57,0,35,0,0,95,0,95,124,56,0,0,0,0,44,24,0,24
175,Concord,0.012665862,21,19116,17740,15187,769,0,1414,0,0,370,24,346,1376,726,0,0,0,0,515,135,99,36
176,Marion,0.054973822,21,5132,4904,4345,72,0,84,0,213,190,42,148,228,182,2,0,0,0,44,0,0,0
177,Southwick,0.028129395,20,9720,9381,9024,7,38,164,0,0,148,0,148,339,277,0,0,0,0,62,0,0,0
178,Rehoboth,0.050632911,20,12173,11833,11242,64,0,173,25,14,315,30,285,340,267,22,0,0,9,31,11,0,11
179,Sturbridge,0.029585799,20,9539,9254,8798,75,0,293,0,58,30,1,29,285,149,0,0,0,0,136,0,0,0
180,Holliston,0.04415011,20,14724,14154,12863,134,0,809,0,31,317,57,260,570,505,39,0,0,0,5,21,0,21
181,Wellesley,0.012399256,20,28747,27278,22011,664,25,3569,21,100,888,57,831,1469,1084,171,0,1,0,146,67,28,39
182,Halifax,0.071161049,19,7842,7791,7543,182,7,28,0,0,31,0,31,51,0,0,0,0,0,51,0,0,0
183,Chatham,0.04185022,19,6019,5883,5692,111,0,19,0,0,61,0,61,136,107,29,0,0,0,0,0,0,0
184,Wilbraham,0.029032258,18,14638,13222,12480,408,0,133,0,0,201,0,201,1416,1195,54,0,0,0,102,65,0,65
185,Littleton,0.042154567,18,10071,9944,8965,62,0,597,0,35,285,29,256,127,116,0,8,0,0,3,0,0,0
186,Avon,0.041463415,17,4500,4310,3224,820,16,120,0,40,90,9,81,190,87,0,0,0,0,102,1,0,1
187,Dalton,0.022696929,17,6610,6469,6309,7,23,107,0,0,23,0,23,141,133,0,0,0,0,8,0,0,0
188,Williamstown,0.027914614,17,7514,7053,5942,376,50,467,0,17,201,17,184,461,186,9,10,10,0,112,134,19,115
189,Rockport,0.016504854,17,7231,7179,6980,4,0,4,0,111,80,0,80,52,32,0,0,0,0,20,0,0,0
190,Monson,0.027823241,17,8779,8644,8418,96,0,45,0,10,75,0,75,135,55,0,0,35,0,26,19,0,19
191,West Bridgewater,0.047904192,16,7198,6972,6678,128,0,71,0,0,95,0,95,226,226,0,0,0,0,0,0,0,0
192,Mattapoisett,0.028368794,16,6336,6182,6035,0,0,0,0,56,91,0,91,154,136,0,0,0,0,17,1,1,0
193,Grafton,0.00968523,16,18743,17564,14786,534,0,1514,0,202,528,13,515,1179,906,54,0,0,0,64,155,52,103
194,Orleans,0.031914894,15,5808,5699,5423,210,0,66,0,0,0,0,0,109,34,0,0,0,0,37,38,38,0
195,Douglas,0.024193548,15,8859,8353,8069,28,0,160,0,0,96,15,81,506,477,0,0,0,0,16,13,0,13
196,Hardwick,0.038265306,15,3048,2900,2863,19,2,4,0,0,12,0,12,148,82,0,0,0,0,13,53,35,18
197,Winchester,0.013992537,15,22738,22257,18071,64,0,3310,0,269,543,16,527,481,328,0,0,13,7,57,76,14,62
198,West Brookfield,0.028455285,14,3728,3601,3515,9,0,0,0,34,43,0,43,127,42,0,59,0,0,26,0,0,0
199,Hopedale,0.040697674,14,5947,5889,5714,19,0,27,0,19,110,24,86,58,10,0,0,0,0,25,23,23,0
200,Boylston,0.046666667,14,4623,4432,4282,9,0,122,0,0,19,0,19,191,161,0,0,0,0,6,24,0,24
201,Lancaster,0.02417962,14,8044,7454,6551,557,0,158,17,6,165,54,111,590,486,40,0,0,0,21,43,39,4
202,Sutton,0.038348083,13,9444,9291,8719,199,0,196,15,20,142,0,142,153,143,9,0,0,0,1,0,0,0
203,Sheffield,0.059633028,13,3160,3089,3076,0,5,0,0,8,0,0,0,71,71,0,0,0,0,0,0,0,0
204,Georgetown,0.02056962,13,8695,8392,8103,44,33,107,0,0,105,0,105,303,231,24,0,0,0,48,0,0,0
205,Cheshire,0.04887218,13,3159,3083,3042,18,7,0,0,0,16,0,16,76,52,14,7,0,0,0,3,0,3
206,Rutland,0.025193798,13,8685,8400,7998,3,0,360,0,0,39,0,39,285,150,0,0,0,0,47,88,88,0
207,Southborough,0.036723164,13,10121,9724,8016,57,0,1459,0,85,107,0,107,397,249,10,0,0,0,138,0,0,0
208,Acushnet,0.024074074,13,10529,10171,9355,7,0,207,0,330,272,91,181,358,309,0,0,0,0,33,16,16,0
209,Boxborough,0.016997167,12,5561,5279,4080,41,0,1000,0,0,158,0,158,282,173,0,0,0,0,94,15,0,15
210,Granby,0.035820896,12,6322,6074,5831,64,0,50,0,46,83,0,83,248,199,0,0,0,0,49,0,0,0
211,Dennis,0.00660066,12,13939,13642,12655,554,84,133,9,42,165,25,140,297,222,0,0,0,0,75,0,0,0
212,Westminster,0.045977011,12,7766,7508,7471,0,0,18,0,0,19,0,19,258,258,0,0,0,0,0,0,0,0
213,Upton,0.030075188,12,7894,7613,6332,600,0,229,0,0,452,0,452,281,160,0,0,0,0,58,63,55,8
214,Edgartown,0.036923077,12,4320,4020,3487,52,0,31,0,97,353,0,353,300,245,0,27,0,0,28,0,0,0
215,Sunderland,0.011988012,12,3647,3468,2901,43,0,252,106,0,166,36,130,179,103,20,0,11,0,0,45,0,45
216,Southampton,0.050458716,11,6144,6144,5875,25,0,143,0,0,101,0,101,0,0,0,0,0,0,0,0,0,0
217,Nahant,0.023305085,11,3502,3449,3341,0,0,78,0,0,30,0,30,53,17,0,0,0,0,33,3,1,2
218,Norwell,0.046218487,11,11054,10798,10443,30,0,207,8,30,80,7,73,256,188,0,0,0,0,68,0,0,0
219,Lanesborough,0.060773481,11,2973,2973,2866,55,0,33,0,0,19,0,19,0,0,0,0,0,0,0,0,0,0
220,Oak Bluffs,0.024390244,11,4665,4567,4080,217,0,0,0,111,159,38,121,98,80,18,0,0,0,0,0,0,0
221,Merrimac,0.028653295,10,6890,6724,6590,16,0,69,0,0,49,0,49,166,75,0,0,0,0,91,0,0,0
222,Huntington,0.061349693,10,2058,2038,1969,16,10,0,0,5,38,0,38,20,7,0,0,0,0,13,0,0,0
223,Brookfield,0.054054054,10,3441,3440,3300,11,0,48,0,28,53,0,53,1,1,0,0,0,0,0,0,0,0
224,Sterling,0.038022814,10,8091,7681,7479,89,0,35,0,31,47,0,47,410,336,16,0,0,0,19,39,39,0
225,Wayland,0.0243309,10,13802,13139,10993,97,0,1585,35,50,379,0,379,663,588,0,0,0,0,18,57,0,57
226,Rowley,0.024213075,10,6372,6321,6076,74,0,68,0,0,103,0,103,51,37,0,0,0,0,14,0,0,0
227,Barre,0.029069767,10,5539,5407,5194,122,0,33,0,0,58,22,36,132,50,0,0,0,30,0,52,23,29
228,Dighton,0.032846715,9,7730,7696,7113,224,0,0,52,202,105,90,15,34,15,13,0,0,0,6,0,0,0
229,Groveland,0.028571429,9,6780,6565,6500,0,0,47,0,0,18,0,18,215,168,0,18,0,0,29,0,0,0
230,Mendon,0.040909091,9,6115,5972,5644,6,0,95,0,0,227,0,227,143,143,0,0,0,0,0,0,0,0
231,Wellfleet,0.033472803,8,3617,3573,3226,70,0,120,0,35,122,0,122,44,44,0,0,0,0,0,0,0,0
232,Ashburnham,0.046511628,8,6281,6173,6026,71,0,17,0,0,59,0,59,108,89,0,0,0,0,0,19,0,19
233,Groton,0.01384083,8,11313,11159,10298,17,0,408,0,14,422,28,394,154,125,10,0,0,0,0,19,0,19
234,Northfield,0.040201005,8,2981,2860,2821,8,0,6,0,0,25,0,25,121,0,0,0,0,0,121,0,0,0
235,Middleton,0.023054755,8,9872,9262,8910,77,5,123,0,0,147,0,147,610,262,68,0,0,0,92,188,9,179
236,Millville,0.028673835,8,3256,3226,3137,16,0,1,0,6,66,0,66,30,29,0,0,0,0,1,0,0,0
237,Barnstable,0.00170249,8,44406,41770,37453,2503,122,408,54,464,766,97,669,2636,2399,62,33,0,0,93,49,35,14
238,Lee,0.011510791,8,5742,5664,5144,111,9,185,0,190,25,0,25,78,42,3,0,0,0,33,0,0,0
239,Russell,0.086419753,7,1470,1408,1316,42,5,0,0,0,45,0,45,62,62,0,0,0,0,0,0,0,0
240,Becket,0.1,7,1941,1866,1793,28,0,0,0,7,38,0,38,75,35,0,0,0,0,28,12,12,0
241,Bolton,0.061946903,7,5299,5225,4900,13,0,223,0,0,89,2,87,74,41,2,0,0,0,0,31,8,23
242,Hadley,0.014141414,7,5319,5195,4498,421,24,179,0,0,73,24,49,124,46,0,0,0,0,56,22,22,0
243,Foxborough,0.002825999,7,17727,16785,14848,1010,0,624,0,12,291,37,254,942,519,49,0,0,0,55,319,58,261
244,Templeton,0.011925043,7,8130,7898,7692,3,24,179,0,0,0,0,0,232,163,0,0,0,0,69,0,0,0
245,Norfolk,0.05,7,11786,10892,9811,732,25,146,0,16,162,16,146,894,353,145,0,0,0,352,44,44,0
246,Lenox,0.008917197,7,4963,4658,4432,138,0,31,0,0,57,18,39,305,122,21,12,0,0,119,31,16,15
247,Ashby,0.078651685,7,3220,3140,3068,7,4,23,0,0,38,0,38,80,64,7,0,0,0,9,0,0,0
248,West Newbury,0.04379562,6,4631,4509,4455,0,0,44,0,0,10,0,10,122,122,0,0,0,0,0,0,0,0
249,Longmeadow,0.010810811,6,15791,14711,13331,150,0,933,0,1,296,0,296,1080,888,0,8,0,0,89,95,48,47
250,Berlin,0.029126214,6,3182,3175,3086,13,0,29,0,0,47,0,47,7,7,0,0,0,0,0,0,0,0
251,Stockbridge,0.02,6,1795,1747,1576,87,0,40,0,0,44,0,44,48,10,0,9,0,0,29,0,0,0
252,Brimfield,0.034682081,6,3658,3578,3365,141,0,18,0,0,54,0,54,80,68,0,0,0,0,0,12,0,12
253,Princeton,0.109090909,6,3455,3403,3282,11,0,8,0,0,102,9,93,52,34,4,0,0,0,14,0,0,0
254,Weston,0.011173184,6,12112,11655,9251,210,0,1567,0,175,452,62,390,457,298,15,18,0,0,102,24,0,24
255,Richmond,0.142857143,5,1489,1482,1424,9,2,21,0,0,26,0,26,7,5,0,0,0,0,0,2,2,0
256,Oakham,0.151515152,5,1833,1795,1770,6,4,4,0,0,11,0,11,38,32,0,0,0,0,6,0,0,0
257,Wenham,0.035460993,5,5240,4957,4603,128,0,165,4,9,48,19,29,283,239,13,0,10,0,11,10,0,10
258,Wales,0.032679739,5,2088,1973,1948,6,3,0,0,0,16,0,16,115,103,0,0,0,4,3,5,0,5
259,Stow,0.016891892,5,7133,6929,6307,1,0,250,0,211,160,54,106,204,203,0,0,0,0,1,0,0,0
260,Dover,0.037878788,5,6044,5856,5124,0,0,611,0,0,121,0,121,188,168,0,0,20,0,0,0,0,0
261,Charlemont,0.051020408,5,1086,1059,996,0,0,10,0,0,53,0,53,27,22,0,0,0,0,0,5,3,2
262,Holland,0.04,5,2630,2565,2523,21,4,0,0,0,17,0,17,65,44,0,0,0,0,13,8,8,0
263,Rochester,0.037593985,5,5580,5545,5433,35,0,48,0,29,0,0,0,35,0,0,0,0,0,25,10,10,0
264,Buckland,0.021929825,5,1950,1942,1758,42,0,96,0,0,46,0,46,8,8,0,0,0,0,0,0,0,0
265,Essex,0.019305019,5,3745,3734,3707,0,0,0,0,0,27,9,18,11,0,0,0,0,0,11,0,0,0
266,Berkley,0.068493151,5,6730,6723,6518,5,0,0,0,89,111,0,111,7,5,0,0,0,0,2,0,0,0
267,Lincoln,0.004549591,5,6830,6240,5558,57,0,432,0,8,185,0,185,590,499,39,0,0,0,0,52,12,40
268,Otis,0.041666667,4,1393,1372,1353,0,5,0,0,0,14,0,14,21,21,0,0,0,0,0,0,0,0
269,Paxton,0.058823529,4,4900,4705,4180,403,0,77,6,0,39,6,33,195,146,6,0,16,0,27,0,0,0
270,Hubbardston,0.018018018,4,4708,4436,4166,36,0,164,0,0,70,0,70,272,225,9,0,0,0,0,38,25,13
271,Hatfield,0.009615385,4,3274,3169,3125,13,0,9,0,9,13,0,13,105,43,0,22,0,0,40,0,0,0
272,Montague,0.002528445,4,8279,7929,7358,160,127,19,0,0,265,0,265,350,127,0,0,0,0,175,48,26,22
273,Plympton,0.028985507,4,2954,2879,2774,83,0,0,0,14,8,0,8,75,64,0,0,5,0,6,0,0,0
274,Easton,0.002079002,4,24621,23881,21688,1025,10,608,0,272,278,19,259,740,567,21,0,0,0,116,36,17,19
275,Hinsdale,0.022222222,4,1837,1817,1797,0,0,0,4,0,16,0,16,20,0,0,0,0,0,5,15,15,0
276,Ashfield,0.032786885,4,1449,1410,1362,1,2,7,0,3,35,3,32,39,22,0,0,0,0,5,12,6,6
277,West Stockbridge,0.05,3,1084,1046,961,51,2,17,5,0,10,1,9,38,4,0,13,0,0,21,0,0,0
278,Hampden,0.017241379,3,5178,4985,4861,10,21,38,0,13,42,16,26,193,130,0,0,0,0,63,0,0,0
279,Hamilton,0.005780347,3,8031,7911,7305,21,0,478,17,12,78,2,76,120,93,0,0,0,0,14,13,0,13
280,Carlisle,0.02970297,3,5224,5181,4487,0,0,595,0,0,99,33,66,43,30,0,0,0,0,13,0,0,0
281,Rowe,0.176470588,3,441,432,427,5,0,0,0,0,0,0,0,9,2,0,0,0,0,3,4,1,3
282,Erving,0.025641026,3,1740,1689,1615,24,16,0,0,0,34,8,26,51,51,0,0,0,0,0,0,0,0
283,Sherborn,0.049180328,3,4316,4222,3779,28,0,267,0,11,137,0,137,94,63,0,0,0,0,14,17,17,0
284,Wendell,0.038461538,3,862,851,760,38,0,7,0,0,46,0,46,11,7,1,0,0,0,1,2,0,2
285,Leverett,0.034482759,3,2001,1976,1892,6,6,42,0,3,27,0,27,25,20,0,0,0,0,5,0,0,0
286,Truro,0.028571429,3,1122,1105,1066,38,0,0,0,0,1,0,1,17,17,0,0,0,0,0,0,0,0
287,Clarksburg,0.053571429,3,1777,1739,1707,20,0,0,0,0,12,0,12,38,22,0,0,0,0,1,15,8,7
288,Boxford,0.046153846,3,8282,8086,7747,0,0,163,0,0,176,0,176,196,83,0,0,0,0,0,113,0,113
289,Bernardston,0.010309278,2,2064,2056,2044,0,0,0,0,6,6,6,0,8,0,0,0,0,0,8,0,0,0
290,Chester,0.018181818,2,1470,1466,1456,4,0,0,0,0,6,0,6,4,4,0,0,0,0,0,0,0,0
291,Granville,0.055555556,2,1691,1630,1615,0,0,3,0,0,12,0,12,61,61,0,0,0,0,0,0,0,0
292,Phillipston,0.037037037,2,1784,1761,1651,27,0,12,0,0,71,0,71,23,23,0,0,0,0,0,0,0,0
293,Harvard,0.02247191,2,6569,6170,5355,341,32,340,0,55,47,0,47,399,249,27,0,0,0,56,67,23,44
294,West Tisbury,0.015037594,2,2418,2356,2250,24,0,23,0,0,59,0,59,62,41,0,0,0,0,14,7,0,7
295,Williamsburg,0.006097561,2,2576,2525,2501,24,0,0,0,0,0,0,0,51,36,0,0,0,0,7,8,6,2
296,East Brookfield,0.016129032,2,2040,1982,1951,22,9,0,0,0,0,0,0,58,28,0,0,0,0,30,0,0,0
297,Warwick,0.090909091,2,796,780,757,0,2,4,0,0,17,0,17,16,12,0,0,0,0,4,0,0,0
298,Cummington,0.020618557,2,845,831,815,0,0,5,0,0,11,0,11,14,14,0,0,0,0,0,0,0,0
299,Topsfield,0.009389671,2,6568,6458,6229,9,0,172,0,0,48,0,48,110,89,0,0,0,0,16,5,0,5
300,Dunstable,0.032786885,2,3366,3297,3118,0,0,136,0,0,43,0,43,69,65,0,0,0,0,4,0,0,0
301,Shutesbury,0.027027027,2,1755,1677,1545,13,0,21,0,6,92,4,88,78,55,0,3,0,0,9,11,10,1
302,Petersham,0.029850746,2,1188,1148,1125,0,0,12,2,0,9,9,0,40,18,3,0,0,0,9,10,0,10
303,Colrain,0.015748031,2,1771,1742,1718,8,0,0,0,0,16,0,16,29,26,0,0,0,0,0,3,0,3
304,Royalston,0.019230769,2,1366,1366,1351,0,0,10,0,0,5,0,5,0,0,0,0,0,0,0,0,0,0
305,Chilmark,0.010752688,1,1222,1164,1143,11,0,3,0,0,7,0,7,58,10,17,0,0,0,0,31,0,31
306,Montgomery,0.142857143,1,798,787,755,4,0,10,0,2,16,0,16,11,11,0,0,0,0,0,0,0,0
307,Plainfield,0.018518519,1,661,635,609,2,2,15,0,0,7,0,7,26,11,0,0,0,0,6,9,0,9
308,Aquinnah,0.028571429,1,531,471,295,0,116,2,0,1,57,5,52,60,60,0,0,0,0,0,0,0,0
309,Monterey,0.022222222,1,774,767,750,3,0,3,0,11,0,0,0,7,5,0,0,0,0,0,2,0,2
310,Newbury,0.002857143,1,7060,6850,6501,19,0,112,0,170,48,0,48,210,116,54,0,0,0,0,40,0,40
311,Savoy,0.041666667,1,680,658,585,57,2,0,0,0,14,0,14,22,19,2,0,0,0,1,0,0,0
312,Peru,0.041666667,1,823,801,790,2,0,0,0,0,9,0,9,22,2,2,0,0,0,0,18,14,4
313,Whately,0.009259259,1,1584,1529,1510,0,0,10,0,0,9,0,9,55,20,0,0,0,0,7,28,28,0
314,Goshen,0.020408163,1,913,861,861,0,0,0,0,0,0,0,0,52,49,0,0,0,0,3,0,0,0
315,Freetown,0.003333333,1,9299,9019,8655,44,6,66,0,37,211,35,176,280,134,0,0,0,0,81,65,0,65
316,Blandford,0.041666667,1,1105,1087,1074,0,4,0,0,0,9,0,9,18,18,0,0,0,0,0,0,0,0
317,Florida,0.024390244,1,808,794,770,0,0,0,0,0,24,0,24,14,0,0,0,0,0,8,6,0,6
